000000000000000000000000000000000000000000000
000000000000000000000000000000000000000000000
000000000000000000000000000000000000000000000
00000000WWWWWWWWWWWWWWWWWWWWWWWWWWWWWW0000000
00000000WWFPFWWWWF?FFF?FFFFFFFFFFFFFAW0000000
00000000WWFFFWWWWFFFTF?FFFFFFFFFFFFFFW0000000
00000000WWAAAWWWWWWWWWWWWWWWWWWWWFFFFW0000000
00000000WWFFFWWWWWWWWWWWWWWWWWWWFFFFWW0000000
00000000WWFFWWWWWWWWWWWWWWWWWWWFFFFWWW0000000
00000000WW?WWWWWWWWWWWWWWWWWWWFFFFWW?W0000000
00000000WWWWWWWWWWWWWWWWWWWWWFFFFWWWAW0000000
00000000WWWWWWWWWWWWWWWWWWWWFFFFWWWWAW0000000
00000000WWWWWWWWWWWWWWWWWWWFFFFWWWWFAW0000000
00000000WWWWWWWWWWWWWWWWWWFFFFWWWWFFFW0000000
00000000WFFFFFFFLFFFFFFFWFFFFWWWWFFFFW0000000
00000000WFGFFFFFLFFFBFFF?FFFFFFFFFF?FW0000000
00000000WFFFFFFFLFFFFFFF?FFFFFFFFFFFFW0000000
00000000WWWWWWWWWWWWWWWWWWWWWWWWWWWWWW0000000
000000000000000000000000000000000000000000000
000000000000000000000000000000000000000000000
000000000000000000000000000000000000000000000

Teleporter(36,9)(10,9)
Teleporter(10,9)(36,9)
Key(18,4)(blue)
Door(24,15)(blue)
Door(24,16)(blue)
Key(35,15)(yellow)
Door(22,4)(yellow)
Door(22,5)(yellow)
Door(20,12)(5)

Start(24,4)
Straight(32,7)(right)
Straight(32,9)(left)
Straight(30,11)(right)
Straight(26,13)(right)