0000000000000000000000000000000000
0000000000000000000000000000000000
0000000000000000000000000000000000
0000000000000WWWWWWWW0000000000000
0000000000000WFFFTFFW0000000000000
0000000000000WFFFFFFW0000000000000
000000WWWWWWWWWWAAWWWWWWWWWW000000
000000W?FFFFFFFFFFFFFFFFFFFW000000
000WWWWFFFFFFFFFFFFFFFFFFFFWWWW000
000WFFWFFFFFFWWWWWWWWFFFFFFWFFW000
000WPF?FFFFFFW??FFATWFFFFFF?FBW000
000WFF?FFFFFFWLLFFATWFFFFFF?FFW000
000WFFWFFFFFFWWWFFWWWFFFFFFWFFW000
000WWWWFFFFFFFFFFFFFFFFFFFFWWWW000
000000WFFFFFFFFFFFFFFFFFFFFW000000
000000WWWWWWWWWWLLWWWWWWWWWW000000
0000000000000WFFFGFFW0000000000000
0000000000000WFFFFFFW0000000000000
0000000000000WWWWWWWW0000000000000
0000000000000000000000000000000000
0000000000000000000000000000000000
0000000000000000000000000000000000

Door(15,10)(3)
Key(14,10)(red)
Door(6,10)(red)
Door(6,11)(red)
Key(7,7)(yellow)
Door(27,10)(yellow)
Door(27,11)(yellow)

Start(17,10)
WallF(21,14)(right)
WallF(26,8)(up)
WallF(15,7)(left)
WallF(7,12)(down)