00000000000000000000000000000000000000
00000000000000000000000000000000000000
00000000000000000000000000000000000000
000WWWWWWWWWWWWWWWWWWWWWWWWWWWWWWWW000
000WFGFLFFFFFFFLFFFFFFFLFFFFFFFLFFW000
000WFFFLFFFFFFFLFFFFFFFLFFFFFFFLFPW000
000WLLLLFFFFFFFLFFFFFFFLFFFFFFFLFFW000
000WFFFFFFFLFFFFFFFLFFFFFFFLFFFFFFW000
000WFFFFFFFLFFF?FFFLFFF?FFFLFFFFFFW000
000WFFFFFFFLFFFFFFFLFFFFFFFLFFFFFFW000
000WWWWWWWWWWWWWWWWWWWWWWWWWWWWWWWW000
00000000000000000000000000000000000000
00000000000000000000000000000000000000
00000000000000000000000000000000000000

Teleporter(15,8)(23,8)
Teleporter(23,8)(15,8)

Start(9,8)
Dumb(6,8)